aa r=Q@
aa=Q
ae={
ah=V
ao r=O@
ao=O:
eh r=e@
eh=e
er=@r
ih r=I@
ih=I
iy r=I@
iy=i:
uh r=U@
uh=U
uw r=U@
uw=u:
aw=aU
ay=aI
ey r=e@
ey=eI
ow r=O@
ow=@U
oy=OI
b=b
ch=tS
d=d
dh=D
f=f
g=g
hh=h
jh=dZ
k=k
l=l
m=m
n=n
ng=N
p=p
r=r
s=s
sh=S
t=t
th=T
v=v
w=w
y=j
z=z
zh=Z