aa=A
ae={
ah=V
ao=O
aw=aU
ay=aI
ch=tS
dh=D
eh=E
er=3
ey=eI
hh=h
ih=I
iy=i
jh=dZ
ng=N
ow=oU
oy=OI
sh=S
th=T
uh=U
uw=u
zh=Z
b=b
d=d
f=f
g=g
k=k
l=l
m=m
n=n
p=p
r=r
s=s
t=t
v=v
w=w
y=y
z=z