aa=a
ae=@
ah=u
ao r=0 r
ao=9
aw=8
ay=I
ch=ch
dh=dh
eh=e
er=3
ey=A
hh iy=hh E
hh y=hhy
hh=h
ih=i
iy=E
jh=j
ng=ng
ow l=0 l
ow=O
oy=Q
s k=sk
s p=sp
s t=st
s m=sm
s n=sn
sh=sh
th=th
uh=6
uw=o
zh=zh
b=b
d=d
f=f
g=g
k=k
l=l
m=m
n=n
p=p
r=r
s=s
t=t
v=v
w=w
y=y
z=z
ae n=& n
ae m=& m
