aa=aa
ae=ae
ah=ah
ao=ao
aw=aw
ay=ay
ch=ch
d r=dr
dh=dh
eh=eh
er=er
ey=ey
hh=hh
ih=ih
iy=iy
jh=jh
ng=ng
ow=ow
oy=oy
sh=sh
t r=tr
th=th
uh=uh
uw=uw
zh=zh
b=b
d=d
f=f
g=g
k=k
l=l
m=m
n=n
p=p
r=r
s=s
t=t
v=v
w=w
y=y
z=z