t r=tr
d r=dr
0 l=ow l
0 r=ao r
1ng=ih ng
ch=ch
dd=dx
dh=dh
hh=hh
hhy=hh y
ng=ng
sh=sh
sk=s k
sm=s m
sn=s n
sp=s p
st=s t
th=th
zh=zh
@=ae
&=ae 
0=ao
1=ih
3=er
6=uh
8=aw
9=ao
a=aa
A=ey
b=b
d=d
e=eh
E=iy
f=f
g=g
h=hh
i=ih
I=ay
j=jh
k=k
l=l
m=m
n=n
o=uw
O=ow
p=p
Q=oy
r=r
s=s
t=t
u=ah
v=v
w=w
x=ax
y=y
z=z