cl=Asp
pau=Asp
sil=Asp
br=br1
a=a
i=i
u=M
e=e
o=o
N=N\
ry=4'
ky=k'
py=p'
dy=d'
ty=t'
ny=J
hy=C
my=m'
gy=g'
by=b'
d=d
sh=S
j=dZ
z=dz
ts=ts
k=k
g=g
h=h
b=b
p=p
f=p\
f y=p\'
ch=tS
n=n
m=m
r=4
w=w
y=j
v=p\
s=s
t=t