aa=a
ae=@
ah=u
ao r=0 r
ao=9
aw=8
ax=x
ay=I
br=
ch=ch
cl=
dh=dh
dr=d r
dx=dd
eh=e
er=3
ey=A
hh y=hh y
hh=h
ih=i
iy=E
jh=j
ng=ng
ow=O
oy=Q
pau=
s k=sk
s p=sp
s t=st
sh=sh
sil=
th=th
tr=t r
uh=6
uw=o
zh=zh
b=b
d=d
f=f
g=g
k=k
l=l
m=m
n=n
p=p
r=r
s=s
t=t
v=v
w=w
y=y
z=z