aa=A
ae={
ah=V
ao=O
aw=aU
ax=@
ay=aI
br=
ch=tS
cl=
dh=D
dr=dZ r
dx=4
eh=E
er=3
ey=eI
hh=h
ih=I
iy=i
jh=dZ
ng=N
ow=oU
oy=OI
pau=
sh=S
sil=
th=T
tr=tS r
uh=U
uw=u
zh=Z
b=b
d=d
f=f
g=g
k=k
l=l
m=m
n=n
p=p
r=r
s=s
t=t
v=v
w=w
y=j
z=z