aa=aa
ae=ae
ah=ah
ao=ao
aw=aw
ax=ah
ay=ay
br=
ch=ch
cl=
dh=dh
dr=jh r
dx=d
eh=eh
er=er
ey=ey
hh=hh
ih=ih
iy=iy
jh=jh
ng=ng
ow=ow
oy=oy
pau=
sh=sh
sil=
th=th
tr=ch r
uh=uh
uw=uw
zh=zh
b=b
d=d
f=f
g=g
k=k
l=l
m=m
n=n
p=p
r=r
s=s
t=t
v=v
w=w
y=y
z=z