aa=Q
ae={
ah=V
ao=O:
aw=aU
ax=@
ay=aI
br=br1
ch=tS
cl=Asp
dh=D
dr=dh r
dx=d
eh=e
er=@r
ey=eI
hh=h
ih=I
iy=i:
jh=dZ
ng=N
ow=@U
oy=OI
pau=Asp
sh=S
sil=Asp
th=T
tr=th r
uh=U
uw=u:
zh=Z
b=b
d=d
f=f
g=g
k=k
l=l
m=m
n=n
p=p
r=r
s=s
t=t
v=v
w=w
y=j
z=z