@r=er
@U=ow
aI=ay
Asp=cl
aU=aw
bh=b
br1=br
br2=br
br3=br
br4=br
br5=br
dh r=dr
dh=d
dZ=jh
e@=eh r
eI=ey
gh=g
i:=iy
I@=ih r
kh=k
l0=l
O:=ao
O@=ao r
OI=oy
ph=p
Q@=aa r
th r=tr
th=t
tS=ch
u:=uw
U@=uh r
{=ae
@=ax
b=b
d=d
D=dh
e=eh
f=f
g=g
h=h
I=ih
j=y
k=k
l=l
m=m
n=n
N=ng
p=p
Q=aa
r=r
s=s
S=sh
t=t
T=th
U=uh
V=ah
v=v
w=w
z=z
Z=zh