@=ah
@U=ow
@l=ah l
@r=er
I=ih
I@=ih r
O:=ao
O@=ao r
OI=oy
Q=aa
Q@=aa r
U=uh
U@=uh r
V=ah
aI=ay
aU=aw
e=eh
e@=eh r
e@0=ae
eI=ey
i:=iy
u:=uw
{=ae
4=d
D=dh
N=ng
S=sh
T=th
Z=zh
b=b
bh=b
d=d
dZ=jh
dh=d
f=f
g=g
gh=g
h=hh
h\=hh
j=y
k=k
kh=k
l0=l
l=l
m=m
n=n
p=p
ph=p
r=r
R=r
s=s
t=t
tS=ch
th=t
v=v
w=w
z=z
Sil=
Asp=
br1=
br2=
br3=
br4=
br5=
