@r=3
@U=oU
aI=aI
aU=aU
bh=b
dh=d
dZ=dZ
e@=E r
eI=eI
gh=g
i:=i
I@=I r
kh=k
l0=l
O:=O
O@=O r
OI=OI
ph=p
Q@=A r
th=t
tS=tS
u:=u
U@=U r
{={
@=@
b=b
d=d
D=D
e=E
f=f
g=g
h=h
I=I
j=j
k=k
l=l
m=m
n=n
N=N
p=p
Q=A
r=r
s=s
S=S
t=t
T=T
U=U
v=v
V=V
w=w
z=z
Z=Z