@r=3
@U l=0 l
@U=O
aI=I
aU=8
bh=b
dh=d
dZ=j
e@=A r
eI=A
gh=g
h i:=hh E
h y=hhy
i:=E
I@=i r
kh=k
l0=l
O:=9
O@=0 r
OI=Q
ph=p
Q@=a r
s k=sk
s p=sp
s t=st
s m=sm
s n=sn
th=t
tS=ch
u:=o
U@=6 r
{=@
@=x
b=b
d=d
D=dh
e=e
f=f
g=g
h=h
I=i
j=y
k=k
l=l
m=m
n=n
N=ng
p=p
Q=a
r=r
s=s
S=sh
t=t
T=th
U=6
V=u
v=v
w=w
z=z
Z=zh