a=a
i=i
M=u
e=e
o=o
k'=ky
k=k
g'=gy
g=g
N'=gy
N\=N
N=g
s=s
S=sh
z=z
Z=j
dz=z
dZ=j
t'=ty
ts=ts
tS=ch
t=t
d'=dy
d=d
n=n
J=ny
h\=h
h=h
C=hy
p\' i=f i
p\'=f y
p\=f
br1=br
br2=br
br3=br
br4=br
br5=br
b'=by
b=b
p'=py
p=p
m'=my
m=m
j=y
4'=ry
4=r
w=w
Asp=pau
?=cl
Sil=sil
